%%%%%%%%%
%R      %
%  %%%%%%
%  %    %
%  % T  %
%  %    %
%  %M   %
%  %S   %
%  %%%%%%
%       %
%%%%%%%%%